ε 	ε
T_IMPORT 	T_IMPORT
T_ID 	T_ID
T_ENDL 	T_ENDL
T_RETURN 	T_RETURN
T_BREAK 	T_BREAK
T_CONTINUE 	T_CONTINUE
T_LPARENS 	T_LPARENS
T_RPARENS 	T_RPARENS
T_FUNCTION 	T_FUNCTION
T_END 	T_END
T_COMMA 	T_COMMA
T_IF 	T_IF
T_THEN 	T_THEN
T_ELSE 	T_ELSE
T_FOR 	T_FOR
T_ASSIGN 	T_ASSIGN
T_TO 	T_TO
T_DO 	T_DO
T_LOOP 	T_LOOP
T_WHILE 	T_WHILE
T_ITERATE 	T_ITERATE
T_AND 	T_AND
T_OR 	T_OR
T_NOT 	T_NOT
T_EQ 	T_EQ
T_NEQ 	T_NEQ
T_LT 	T_LT
T_GT 	T_GT
T_LE 	T_LE
T_GE 	T_GE
T_PLUS 	T_PLUS
T_MINUS 	T_MINUS
T_TIMES 	T_TIMES
T_DIV 	T_DIV
T_NEG 	T_NEG
T_INT 	T_INT
T_FLOAT 	T_FLOAT
T_STRING 	T_STRING
T_NILL 	T_NILL
T_DOT 	T_DOT
T_LBRACKET 	T_LBRACKET
T_RBRACKET 	T_RBRACKET
T_LBRACES 	T_LBRACES
T_RBRACES 	T_RBRACES
T_COLON 	T_COLON
T_TRUE 	T_TRUE
T_FALSE 	T_FALSE
NT_STMTLIST 	ε, T_IMPORT, T_ENDL, T_RETURN, T_BREAK, T_CONTINUE, T_ID, T_IF, T_WHILE, T_FUNCTION, T_ITERATE, T_FOR
NT_STMT 	T_IMPORT, T_ENDL, T_RETURN, T_BREAK, T_CONTINUE, T_ID, T_IF, T_WHILE, T_FUNCTION, T_ITERATE, T_FOR
NT_CALL 	T_LPARENS
NT_CALL1 	T_RPARENS, T_NOT, T_MINUS, T_NEG, T_LPARENS, T_INT, T_FLOAT, T_STRING, T_NILL, T_TRUE, T_FALSE, T_LBRACKET, T_LBRACES, T_ID
NT_FUNCTIONDEF 	T_FUNCTION
NT_PARAMETERS 	T_LPARENS
NT_PARAMETERS1 	T_RPARENS, T_ID
NT_PARAMDECL 	T_ID
NT_PARAMDECL1 	T_COMMA, ε
NT_IF 	T_IF
NT_ELSEIF1 	T_ELSE, T_END
NT_ELSEIF2 	T_ENDL, T_IF
NT_FORLOOP 	T_FOR
NT_WHILELOOP 	T_WHILE
NT_INDEFINITELOOP 	T_ITERATE
NT_ASSIGNMENT 	T_ASSIGN
NT_CONDITION1 	T_AND, T_OR, ε
NT_LOGIC 	T_NOT, T_MINUS, T_NEG, T_LPARENS, T_INT, T_FLOAT, T_STRING, T_NILL, T_TRUE, T_FALSE, T_LBRACKET, T_LBRACES, T_ID
NT_COMPARISON1 	T_EQ, T_NEQ, T_LT, T_GT, T_LE, T_GE, ε
NT_ARITHMETIC1 	T_PLUS, T_MINUS, ε
NT_TERM1 	T_TIMES, T_DIV, ε
NT_FACTOR 	T_MINUS, T_NEG, T_LPARENS, T_INT, T_FLOAT, T_STRING, T_NILL, T_TRUE, T_FALSE, T_LBRACKET, T_LBRACES, T_ID
NT_FINAL 	T_LPARENS, T_INT, T_FLOAT, T_STRING, T_NILL, T_TRUE, T_FALSE, T_LBRACKET, T_LBRACES, T_ID
NT_LVALUE 	T_ID
NT_LVALUE1 	ε, T_DOT, T_LBRACKET
NT_REFERENCE1 	ε, T_LPARENS
NT_REFERENCE2 	T_RPARENS, T_NOT, T_MINUS, T_NEG, T_LPARENS, T_INT, T_FLOAT, T_STRING, T_NILL, T_TRUE, T_FALSE, T_LBRACKET, T_LBRACES, T_ID
NT_ARGUMENTS1 	ε, T_COMMA
NT_OBJECT 	T_LBRACKET, T_LBRACES
NT_OBJECT1 	T_RBRACKET, T_NOT, T_MINUS, T_NEG, T_LPARENS, T_INT, T_FLOAT, T_STRING, T_NILL, T_TRUE, T_FALSE, T_LBRACKET, T_LBRACES, T_ID
NT_ARRAYINIT1 	ε, T_COMMA
NT_DICTIONARYINIT 	T_ID
NT_DICTIONARYINIT1 	ε, T_COMMA
NT_BOOLEAN 	T_TRUE, T_FALSE
NT_LVSTMT 	T_ASSIGN, T_LPARENS
NT_REFERENCE 	T_ID
NT_PROGRAM 	ε, T_IMPORT, T_ENDL, T_RETURN, T_BREAK, T_CONTINUE, T_ID, T_IF, T_WHILE, T_FUNCTION, T_ITERATE, T_FOR
NT_TERM 	T_MINUS, T_NEG, T_LPARENS, T_INT, T_FLOAT, T_STRING, T_NILL, T_TRUE, T_FALSE, T_LBRACKET, T_LBRACES, T_ID
NT_ARITHMETIC 	T_MINUS, T_NEG, T_LPARENS, T_INT, T_FLOAT, T_STRING, T_NILL, T_TRUE, T_FALSE, T_LBRACKET, T_LBRACES, T_ID
NT_COMPARISON 	T_MINUS, T_NEG, T_LPARENS, T_INT, T_FLOAT, T_STRING, T_NILL, T_TRUE, T_FALSE, T_LBRACKET, T_LBRACES, T_ID
NT_CONDITION 	T_NOT, T_MINUS, T_NEG, T_LPARENS, T_INT, T_FLOAT, T_STRING, T_NILL, T_TRUE, T_FALSE, T_LBRACKET, T_LBRACES, T_ID
NT_EXPR 	T_NOT, T_MINUS, T_NEG, T_LPARENS, T_INT, T_FLOAT, T_STRING, T_NILL, T_TRUE, T_FALSE, T_LBRACKET, T_LBRACES, T_ID
NT_ARGUMENTS 	T_NOT, T_MINUS, T_NEG, T_LPARENS, T_INT, T_FLOAT, T_STRING, T_NILL, T_TRUE, T_FALSE, T_LBRACKET, T_LBRACES, T_ID
NT_ARRAYINIT 	T_NOT, T_MINUS, T_NEG, T_LPARENS, T_INT, T_FLOAT, T_STRING, T_NILL, T_TRUE, T_FALSE, T_LBRACKET, T_LBRACES, T_ID

